==========================   ======================   ==================   ====================   ==
==========================   ======================   =============              ==============   ==
==========================   ======================   =============   ========   ==============   ==
==========================   ======================   =============   ========   ==============   ==
==========================   ======================   =============   ========   ==============   ==
==========                   ======================   =============   ========   ==============   ==
==========   ======================================   =============   ========   ==============   ==
==========   ======================================   =============   ========   ==============   ==
==========   ==============================           =============   ========   ==============   ==
==========   ==============================   =====   =============   ========   ==============   ==
==========   ==============================   =====   =============   ========   ==============   ==
==========   ==============================   =====   =============   ========   ==============   ==
==========   ==============================           =============   ========   ===================
==                 ================================   =============   =========================   ==
================   ================================   =============   =========================   ==
================   ================================   =============   =========================   ==
================   ================================   =============   =========================   ==
================   ================================   =============   =========================   ==
================                                                           ====================   ==
===================================================   =========================================   ==
===================================================   =========================================   ==
                                                                                                  ==
====   ============   ==================   ========   ==================   ===============   =======
====   ============   ==================   ========   ==================   ===============   =======
====   ============   ==================   ========   ==================   ===============   =======
====   ============   ==================   ========   ==================   ===============   =======
====   ============   ==================   ========   ==================   ===============   =======
====   ============   ==================   ========   ==================   ===============   =======
====   ============   ==================              ==================   ===============   =======
====   ============   =============================   ==================   ===============   =======
===================   =============================   ==================   ===============   =======
===================   =============================   ==================   ===============   =======
===================   =============================   ==================   ===============   =======
===================   =============================   ==================   ===============   =======
===================================================   ==================   ===============   =======
===================================================   ==================   ===============   =======
===================================================   ==================   ===============   =======
===================================================   ==================   ===============   =======
===================================================   ==================   ===============   =======
===================================================   ====================================   =======
===================================================   ====================================   =======
===================================================   ==============================================



