=================================   ==========   ==   =========   ====   ===   =   =   ========   ==
=================================   ==========   ==   =========   ====   ===   =   =   ========   ==
                          =======   ==========   ==   =========   ====   ===   =   =
===   =================   =======   ==========   ==   =========   ====   ===   =   =   ========   ==
===   =================   =======   ==========   ==   =========   ====   ===   =   =   ========   ==
===   =================   =======   ==========   ==   =========   ====   ===   =   =   ========   ==
===   =              ==   =======   ==========   ==   =========   ====   ===   =   =   ========   ==
===   ========   =   ==   =======   ==========   ==   =========   ====   ===   =   =   ========   ==
===   ========   =   ==   ==        ==========   ==   =========          ===   =   =   ========   ==
===   ========   =   ==   =======   ==========   ==   ======================   =   =   ========   ==
                 =   ==   =======   ==========   ==   ======================           ========   ==
==   ===   =   ===        =======   ==========   ==   ======================   =====   ========   ==
==   ===   =   ===   ==   =======   ==========   ==   ======================   =====   ========   ==
==   ===   =   ===   ==   =======                ==   ======================   =====   ========   ==
==   ===   =   ===   ==   =======   ===============   ======================   =====              ==
==   ===   =         ==             ===============   ======================   ===== ==========   ==
==   ===   =======   ==   =========================   ================               ==========   ==
==   ===   =======   ==   =========================   ================   ======================   ==
==   ===   =======   ==   =========================   ================   ======================   ==
==   ===   =======   ==   =========================            =======   ======================   ==
==   ===   =======   ==   =========================   ======   =======   ======================   ==
==   ===   =======   ==   =========================   ======   =======   ======================   ==
==   ===   =======   ==   =========================   ======   =======   ======================   ==
==   ===   =======   ==   =========================   ================   ======================   ==
==                        =========================   ================   ======================   ==
==============   ==================================   ================   ======================   ==
==============   ==================================   ================   ======================   ==
==============   ==================================   ================   ======================   ==
==============   ==================================   ================   ======================   ==
==============   =====================                =========================================   ==
==============   ==================================   =========================================   ==
==============   ==================================   =========================================   ==
==============   ==================================                                     =======   ==
==============   ==================================   ===================   ===   ===   =======   ==
==============   ==================================   ===================   ===   ===   =======   ==
==============   ==================================   ===================   ===   ===   =======   ==
==============   ================                     ===================   ===   ===   =======   ==
==============   ================   ===============   =========================   ===   =======   ==
==============   ================   ===============   =========================   ===   =======   ==
==============   ================   ===============   =========================   ===   =======   ==
==============   ================   ===============   =========================   ===   =======   ==
==============   ================   ===============   =========================   ===   =======   ==
==============   ================   ===============   =========================   ===   =======   ==
==============   ================   ===============   ===============================   =======   ==
=========            ============   ===============   ===============================   =======   ==
=========   ======   ============   ===============   ===============================   =======   ==
=========   ======   ============   ===============   ===============================   =======   ==
=========   ======   ============   ===============   ===============================   =======   ==
=========   ======   ============   ===============                        ==========   =======   ==
==================           ====   ===============   ====   ==   ======   ==========   =======   ==
==================   =====   ====   ===============   ====   ==   ======   ==========   =======   ==
==================   =====   ====   ===============   ====   ==   ======   ==========   =======   ==
==================   =====   ====   ===============   ==================   ==========   =======   ==
==================   =====   ====   ===============   ==================   ==========   =======   ==
==========================   ====   ===============   ==================   ==========             ==
==========================   ====   ===============   ==================   ==========   =======   ==
==========================   ====   ===============   ==================   ==========   =======   ==
==========================   =      ===============   ==================   ==========   =======   ==
==========================   ======================   ==================   ====================   ==
==========================   ======================   ==================   ====================   ==
==========================   ======================   =============              ==============   ==
==========================   ======================   =============   ========   ==============   ==
==========================   ======================   =============   ========   ==============   ==
==========================   ======================   =============   ========   ==============   ==
==========                   ======================   =============   ========   ==============   ==
==========   ======================================   =============   ========   ==============   ==
==========   ======================================   =============   ========   ==============   ==
==========   ==============================           =============   ========   ==============   ==
==========   ==============================   =====   =============   ========   ==============   ==
==========   ==============================   =====   =============   ========   ==============   ==
==========   ==============================   =====   =============   ========   ==============   ==
==========   ==============================           =============   ========   ===================
==                 ================================   =============   =========================   ==
================   ================================   =============   =========================   ==
================   ================================   =============   =========================   ==
================   ================================   =============   =========================   ==
================   ================================   =============   =========================   ==
================                                                           ====================   ==
===================================================   =========================================   ==
===================================================   =========================================   ==
                                                                                                  ==
====   ============   ==================   ========   ==================   ===============   =======
====   ============   ==================   ========   ==================   ===============   =======
====   ============   ==================   ========   ==================   ===============   =======
====   ============   ==================   ========   ==================   ===============   =======
====   ============   ==================   ========   ==================   ===============   =======
====   ============   ==================   ========   ==================   ===============   =======
====   ============   ==================              ==================   ===============   =======
====   ============   =============================   ==================   ===============   =======
===================   =============================   ==================   ===============   =======
===================   =============================   ==================   ===============   =======
===================   =============================   ==================   ===============   =======
===================   =============================   ==================   ===============   =======
===================================================   ==================   ===============   =======
===================================================   ==================   ===============   =======
===================================================   ==================   ===============   =======
===================================================   ==================   ===============   =======
===================================================   ==================   ===============   =======
===================================================   ====================================   =======
===================================================   ====================================   =======
===================================================   ==============================================
